11111111111
10001E11111
1P00001111C
10001011111
11111111111