11111111111
1CCCCC0E001
1P0C0001011
10CC0000011
11111111111