11111111111
1CCCCC0E011
1P0C0101111
10CC1110111
11111111111